111111111111111111111111111111111111111111111111111111111111111111111111111
1E000000C000000000000000000000000000000000000000000000P00000000000000000001
101001010010000010100100000000000000000000000000000100010000000000100010101
1010010010101010001001000000010000000000000001000C0010010100000010101010101
1000000000000000101001001000C0001010000000000000000000000000000001000000101
1011111111111111000000100000010101000000010101010101C1000100000010010000001
10100000000000001000000C000000000001111100000000000000100000001000000001101
111111111111111110000000000000010101010101000101000000000000000000000101011
101000000010001010010010010100000010000000100100000101010000000000001010101
100000010010000100000100010100000C00010100000000000101010101000C00101101001
101111111110000101000100000001010100001000001000010000010101010000000001001
10000000000000001001010110000000000010000010000C000000100000000101011110101
101010100010001000000000100001000000101001100010100101101100000001000000001
1000C001000100000010010010000000100C001010010000010100100000100100000000101
10000100010001010000101010000010101001010110101010101000000001001000C000001
111111111111111111111111111111111111111111111111111111111111111111111111111
