111111111111111111111111111111111111111111111111111111111111111111111111111
1E0000000000000000000000000000000000000000000000000000P00000000000000000001
100000001000000000000100000000000000000000000000000100010000000000100010101
1000000011100000001001110000010111111111111111000C0010010100000010101010101
1000000011100000101001111000C0001010000000001100000000000000000001000000101
1000000011100000000001110000010101000000010111010101C1000100000010010000001
101000001110000010000111000000000000000000001100000000100000001000000001101
100000000111111111111111000000011111111111111101000000000000000000000101011
101000000010001010010111010100111110000000101100000101010000000000001010101
100000010010000100000111010100110C00010100001100000101010101000C00101101001
101111111110000101000111000001110100001000001100010000010101010000000001001
10000000000000001001011100000001111111111111110C000000100000000101011110101
101010100010001000000000100001000000101001100010100101101100000001000000001
1000C001000100000010010010000000100C001010010000010100100000100100000000101
10000100010001010000101010000010101001010110101010101000000001001000C000001
111111111111111111111111111111111111111111111111111111111111111111111111111
