11111111111111111111111111111111111111111111111111111111111111111111111111
10000000000000000000000000000000000000000000000000000000000000000000000001
100P00000000C0000000000000000000000000000000000000000000C000000000000C0001
10000000000000000000000000000000000000000000000000000000000000000000000001
10000000C00000000000111111111100000000001111111110000000000000C00000000001
1000000000000000000011000C000000000000011000000011000000000000000000000001
10000C00000000000000110000000000000000000000C00011000000000000000000000001
10000000000000000000111111111100000000011000000011000000C00000000000C00001
10000000000000000000000000001100000000011000C00011000000000000000000000001
100000000C000000000000C000001100000000011000000000000000000000000000000001
100000000000000000001111111111000000000011111111100000000000000C0000000001
10000000000000000000000000000000000000000000000000000000000000000000000001
10000000000000000000000000000000000000000000000000000000000000000000000001
10000000001100000000000001110011100000001110000001100000111111111000000001
100000000011000000000000110000001100000011011C0001100001111111111000000001
1000C000001100C000000000110C0C0011000000110010000110000110000000C000000001
1000000000110000000000001100C0001100000011C0110001100001100001111110000001
10000000001100C00C000000110C0C00110000001100011001100001100000011000000001
100000000011000000000000110000001100000011000010011000011100E0011000000001
10000000001111111110000001110011100000001100000111100000111111110000000001
1000C0000000000000000000000000000000C00000000000000000000000000000000C0001
10000000000000000000000000000000000000000000000000000000000000000000000001
11111111111111111111111111111111111111111111111111111111111111111111111111
